Ask-i Memnu - Halit Ziya Usakligil
Aylak Adam - Yusuf Atilgan
Bulanti - Jean-Paul Sartre
Bulbulu Oldurmek - Harper Lee
Cesur Yeni Dunya - Aldous Huxley
Calikusu - Resat Nuri Guntekin
Cavdar Tarlasinda Cocuklar - Jerome David Salinger
Denemeler - Michel de Montaigne
Dokunmayin Portakalime(Bir Nefeste Guneydogu) - Bilal Civelek
Dokuzuncu Hariciye Kogusu - Peyami Safa
Don Kisot - Miguel de Cervantes Saavedra
Donusum - Franz Kafka
Eylul - Mehmet Rauf
Fahrenheit 451 - Ray Bradbury
Fareler ve Insanlar - John Steinbeck
Hamlet - William Shakespeare
Hakkari'de Bir Mevsim - Ferit Edgu
Hayvan Ciftligi - George Orwell
Huzur - Ahmet Hamdi Tanpinar
Iki Sehrin Hikayesi - Charles Dickens
Ince Memed - Yasar Kemal
Insan Neyle Yasar - Lev Nikolayevic Tolstoy
Jane Eyre - Charlotte Bronte
Kirmizi ve Siyah - Henri Beyle Stendhal
Korluk - Jose Saramago
Kuyucakli Yusuf - Sabahattin Ali
Kucuk Prens - Antoine de Saint-Exupery
Kurk Mantolu Madonna - Sabahattin Ali
Martin Eden - Jack London
Mutlu Prens - Oscar Wilde
Nietzsche Agladiginda - Irvin D. Yalom
Notre Dame'in Kamburu - Victor Hugo
Nutuk - Mustafa Kemal Ataturk
Otomatik Portakal - Anthony Burgess
Savas ve Baris - Lev Nikolayevic Tolstoy
Saatleri Ayarlama Enstitusu - Ahmet Hamdi Tanpinar
Sefiller - Victor Hugo
Serenad	- Zulfu Livaneli
Simyaci - Paulo Coelho
Suc ve Ceza - Fyodor Mihaylovic Dostoyevski
Tutunamayanlar - Oguz Atay
Ucurtma Avcici - Khaled Hosseini
Veba - Albert Camus
Veba Geceleri - Orhan Pamuk
Yabanci - Albert Camus
Yeraltindan Notlar - Fyodor Mihaylovic Dostoyevski
Yitik Adamin Oykusu- Jose Saramago
Yuzyillik Yalnizlik - Gabriel Garcia Marquez
1984 - George Orwell